1111111111111111111111111111
100C00C00C00C00C00C00C00C001
1011110011110011110011110E01
10P0010C00010000010000010001
1C0001000001000001C000010001
1000010011110011110C00010001
100001000001000C010000010001
100001C00001000001C00C010001
100001000001C00C010000010001
100C010011110011110C00010001
10C0C0C0C0000000000C000C0C01
1111111111111111111111111111