11111111111111111111111
100P0100000000000000011
1000001000C000001000001
100C000100000000010E0C1
10000C0000C00C001000001
11111111111111111111111