11111111111111111111111
100P0100000000000000011
1000001000C0000010C0001
100C0001000000000101E11
10000C0000C00C001000001
11111111111111111111111