11111111111111111111111
100P0100000000000000011
1000001000C000001000001
100C00010000000001000C1
10000C0000C00C00100E001
11111111111111111111111