11111111111111111111111111111111111
1P00000C111111111111100111111000101
11110010100001000000011000010010101
10000010110100101011C11101010110101
101100100001010000100C0000010010101
1000100011100000C00C01000100001C0E1
11111111111111111111111111111111111
