11111111111111111111111111111111111
1P11111C111111111111111111111111C01
10110010100001000000011000010000101
10000010110100101011C11101010110001
101100100001010000100C0000010011011
1000100011100000C00C0100010000110E1
11111111111111111111111111111111111
