11111111111111111111111111111111111111111
10000000000000000000000000000000000000001
100111100P0000000000000000000000011111001
10010010000000000C0C000000000000010001001
1001111000011100C0C0C00111000000010001001
10011000000000000C0C000000000000011111001
100101000000000000C0000000000000010001001
10010010000000000000000E00000000010001001
11111111111111111111111111111111111111111